1111111111111111111111111111111111111111111111111111111111111111111111111111111
1001000000000000000000000000000000000000000000000000000000000000000000000000001
1001000000000000000000000000000000000000000000000000000000000000000000000000001
1001001111111111110001111111111111100000000011111111111111111111100000000000001
1001001000000000010001000000000000000000000000000000100000000000000000000000001
1001001000000000010001000000000000000000000000111111111111000000000000000000001
1000000000000000000001001111111111100000000000000000000000000000000000000000001
1000000000000000000001001111111111110000000000000111111111111111111111000000001
1000001000000000010001001111111111110000000000000000000001000000000000000000001
1000001000000000010001001111111111100000000000000000000000000000000000000000001
1000001111111111110001000000000000000000011111000000000000000000000000000000001
1000000000000000000000000000000000000000011111000000000001000000000000000000001
1000000000000000000000000000000000000000000000000000000001000000000000000000001
1000000100000000000000000000000000000000000000000000000001111111111111111111001
1000000100000000000111111111111110000000000111111000000000000000000000110000001
1000000100000000000000001000000000000000000100000000000000000000000001100000001
1000000100000010000000001000000000000000000100000000000000000000000011000000001
1000000100000010000000001000000000011111111100111111111111111111111110000000001
1000000100000010000000001000000000000000000000000000000000000000001000000000011
1111111111111111111111111111111111111111111111111111111111111111111111111111111

